XXXXXXXXX X XXXXXXX
XG GGGX           X
X X X X XXXXXXX X X
X X X   X     X X X
X XXXXXXX XXXXXXXSX
X X       XU  UPX X
X X XXXXXXX X XXX X
X X X       X  U  X
X XTXXXXX X XXXXXXX
X XS T  X     X   X
XUXXXXXXX XXX XXX X
XP        X       X
XXXXXXXXX X XXXXXXX