XXXXXXXXX XXXXXXXXX
XGX   X         X X
X X XXXXXXXXXXXXXXX
X X X  G        X X
X X X XXXXXXXXX XSX
X X X X    U  XPX X
X X X X XXXXX X X X
X X X     G   XUX X
X XTXXXXXXXXXXX XXX
X XS T     G    X X
XUXXXXXXXXXXXXXXXXX
XP        X       X
XXXXXXXXX XXXXXXXXX