XXXXXXXXXTXXXXXXXXX
X X  PX         X X
X X XXXXXXXXXXXXXXX
X X X           X X
X X X XXXXXXXXX XSX
X X X X       XPX X
X X X X XXXXX X X X
X X X         XUX X
X XTXXXXXXXXXXX XXX
X X       P     X X
XUXXXXXXXXXXXXXXXXX
XU        X      PX
XXXXXXXXX XXXXXXXXX