XXXXXXXXX XXXXXXXXX
XGXG GX         X X
X X X X XXXXXXX X X
X X X   X       X X
X XXXXXXX XXXXXXXSX
X X       XU  UPX X
X X XXXXXXX X XXX X
X X X       X  U  X
X XTX XXX X XXXXXXX
X XS TX X     X   X
XUXXXXXXX XXX XXX X
XP        XG      X
XXXXXXXXX XXXXXXXXX