XXXXXXXXXTXXXXXXXXX
XPX   X         XPX
X X XXXXXXXXXXXXXXX
X X X           X X
X X X XXXXXXXXX XSX
X X X X BBBS  X X X
X X X X XXXXX X X X
X X X         XUX X
X XTXXXXXXXXXXX XXX
X X             X X
XUXXXXXXXXXXXXXXXXX
XP        X      PX
XXXXXXXXX XXXXXXXXX