XXXXXXX XXXXXXX
X  G    XX    X
X    X     XX X
X XXXXXXXXX   X
X           P X
XXXXXXX XXXXXXX
XXXXXXX XXXXXXX