XXXXXXXXXXXXX
X   XXXG    X
X X     XXX X
  XXXXXXXXX  
XP          X
XXXXXXXXXXXXX