XXXXXXXXXTXXXXXXXXX
X_X_G_X_________X_X
X_X_XXXXXXXXXXXXXXX
X_X_X___________X_X
X_X_X_XXXXXXXXX_XSX
X_X_X_X_______XPX_X
X_XPX_X_XXXXX_X_X_X
X_X_X_________XUX_X
X_XTXXXXXXXXXXX_XXX
X_X_____________X_X
XUXXXXXXXXXXXXXXXXX
XU________X____P__X
XXXXXXXXX_XXXXXXXXX