XXXXXXXXXTXXXXXXXXX
XPX  PX    PPP  XPX
X X XXXXXXXXXXXXXXX
X X X    PP    PX X
XPX X XXXXXXXXX XSX
X X X X PBBS  X X X
X XPX X XXXXX X X X
X X XPP      PXUX X
XPXTXXXXXXXXXXXPXXX
X XP    PPP     XPX
XUXXXXXXXXXXXXXXXXX
XP  PP    X  P   PX
XXXXXXXXX XXXXXXXXX